1111111111111111111
1000C000C000C001111
1001011111000001111
10010C00C0000P01111
1001000C00C00E01111
100011111011C0000C1
1111111111111111111