11111111111111111111111111111
1C0000C0000001E1000000C0000C1
10111101111001010011110111101
10100101001000000010010100101
100000C000000101000000C000001
10100101001001010010010100101
10111101111001010011110111101
100000C0000000P0000000C000001
10111101111001010011110111101
10100101001001010010010100101
100000C000000101000000C000001
10100101001000000010010100101
10111101111001010011110111101
1C0000C000000101000000C0000C1
11111111111111111111111111111