111111111111111111111111111111111111111
1E0000000000000000000000000000000000001
101111111111111111111111111111111111111
1C0000000000000000000000000000000000001
111111111111111111111111111111110000001
100000000000000000000000000000000000001
11111111111111111111111111111111000P001
100000000000000000000000000000000000001
111111111111111111111111111111110000001
100000000000000000000000000000000000001
111111111111111111111111111111111111111
