111111111111111111111111111111111111111
1CCCCCCC00000000000000000000000000000E1
1CCCCCCC1000000000000000000000000000001
1CCCCCCC1000000000000000000000000000001
1CCCCCCC1000000000000000000000000000001
1CCCCCCC1000000000000000000000000000001
1CCCCCCC1000000000000000000000000000001
1CCCCCCC1000000000000000000000000000001
100000001000000000000000000000000000001
100000001000000000000000000000000000001
100000001000000000000000000000000000001
1000P0001000000000000000000000000000001
100000001000000000000000000000000000001
100000001000000000000000000000000000001
100000001000000000000000000000000000001
111111111111111111111111111111111111111
