1111111111111111111111
1000000010100000001C11
100C000011100001000001
1000010000000111000001
11111100001101C00001E1
1000C10000C10001100111
100000000000000C1000P1
1111111111111111111111
