1111111111111111111111111111
1C000000000001100000000000C1
1010010100010110100010100101
101111C11111011011111C111101
1010010111110110111110100101
1000000000000000000000000001
1011110110111111110110111101
1011110110111111110110111101
1000000110000110000110000001
1000000110000110000110000001
1011110110000000000110111101
1011110110111001110110111101
1000000110101001010110000001
10000001101E0P00010110000001
1011110110111111110110111101
1011110110000000000110111101
1000000110000110000110000001
1000000110000110000110000001
1011110110111111110110111101
1111111111111111111111111111