1111111111111111111111111111111111111
1E00000000000000000000000000000000101
1000000000000000001000000000000000001
1000101010101010101010101010100001011
1000100010001000100010001000100101001
1111111111111111111111111111111111101
1010101010101010101010101010101010101
1000000000000000000000000000000000001
110101010101110111P111011101010101011
1000000000000000000000000000000000001
1010101010101010101010101010101010101
1011111111111111111111111111111111101
10010001000100010C1C01000100010001001
11010101010101010C1C01010101010101011
10000000000000000C1C00000000000000001
10000000000000000C1C00000000000000001
1111111111111111111111111111111111111
