11111111111111111111111111111
1C0000C0000001E1000000C0000C1
10111101111000000011110111101
10100101001000100010010100101
100000C0000C01010C0000C000001
10100101001000100010010100101
10111101111000000011110111101
100000C0000001P1000000C000001
11111111111111111111111111111