1111111111111111111
10000000000E0001C01
1011111100000101101
101C000101100001101
1011001101100P00001
1000000000000100111
10110011000C0000111
101000C1000110000C1
1011111100111100011
10C1000000000000111
1111111111111111111