111111111111111111
10100C0000C0000001
10C001000010011001
101C010C001C011001
1P000C000010000001
1E000C000000011101
10000C000C0001C001
111111111111111111