1111111111111111111111
1000C000000C00000C0001
1011111111001100011001
10000C0000C0P000011001
10111001110000C0110001
10000C000C00E0000C0001
1111111111111111111111