111111111
1PEC00001
100000011
1000001C1
111111111